BBBBBBBBBBBBBBBBBBBBBBBBBBBBBBBBBBBBBBBBBBBBBBBBBBBBBBBBBBBBBBBB
B                                                              B
B                                                              B
B                                                              B
B                                  BBBBBB B B BBBBBB           B
B                                       S S R R                B
B                                       S S R R                B
B                                       S S R R                B
B                              BBB      S S R R                B
B                                       S S R R                B
B                                       S S R R                B
B                                       S S R R                B
B                   BBBB                S S R R                B
B                                                              B
B                                                              B
B                                                              B
B                                                              B
B                                P                             B
B                                                              B
B           BBBB                                               B
B                                                              B
B                              BBBBB   BJJJJJJBBB              B
B                                                              B
B                                                              B
B            BBBFFFFBBB                          BBBB          B
B                                                              B
B                                                              B
BBBB BBB                           RRRRRRRRRRR                 B
B                                                              B
B                                                              B
B                                                         BBBBBB
B                  B B                                         B
B                  B B                                         B
B                  B B BBBGGGSRJJJJ          ^^^^              B
B                                                              B
BBBBBBBBBSSSIIIIIIISSSBBBBBBBBBBBBBBBBBBBBSSSSSBBBBBBBBBBBBBBBBB
